BBBBBBBBBBBBBBBBBBBBBBBBBBBBBBBBBBBBBBBBBBBBBBBBBBBBBBBBBBBBBBBBBBBBBBBBBBBBBBBB
B                                B                                       B     B
B                                B                                       B     B
B                                B                                       B     B
B                                B                                       B     B
B                                B                                       B     B
B                                B                                       B     B
B                                B                                       B     B
B                                B                                       B     B
B                                B                                       B     B
B                                B                                       B     B
B                                B                                       B     B
B                                B                                       B     B
B                                B                                       B     B
B                                B                                       B     B
B         0000                BBBB                0000                BBBB     B
B                                B                                       B     B
BBB                              B       BB                              B     B
B              BB                BB    BB              BB              BBBB    B
B              BB                      BB              BB                      B
B    B         BB         BB           BB    B         BB         BB           B
B    B         BB         BB           BB    B         BB         BB           B
BBBBBBBBBBBBBBBBBBBBBBBBBBBBBBBBBBBBBBBBBBBBBBBBBBBBBBBBBBBBBBBBBBBBBBBBBBBBBBBB
